XXXXXXXXXXXXXXXXXXXXXXXXXXXX
XOOOOOOOOOOOOXXOOOOOOOOOOOOX
XOXXXXOXXXXXOXXOXXXXXOXXXXOX
XPXXXXOXXXXXOXXOXXXXXOXXXXPX
XOXXXXOXXXXXOXXOXXXXXOXXXXOX
XOOOOOOOOOOOOOOOOOOOOOOOOOOX
XOXXXXOXXOXXXXXXXXOXXOXXXXOX
XOXXXXOXXOXXXXXXXXOXXOXXXXOX
XOOOOOOXXOOOOXXOOOOXXOOOOOOX
XXXXXXOXXXXXEXXEXXXXXOXXXXXX
XXXXXXOXXXXXEXXEXXXXXOXXXXXX
XXXXXXOXXEEEEE1EEEEXXOXXXXXX
XXXXXXOXXEXXXGGXXXEXXOXXXXXX
XXXXXXOXXEXXXGGXXXEXXOXXXXXX
EEEEEEOEEEXXE234XXEEEOEEEEEE
XXXXXXOXXEXXXXXXXXEXXOXXXXXX
XXXXXXOXXEXXXXXXXXEXXOXXXXXX
XXXXXXOXXEEEEEEEEEEXXOXXXXXX
XXXXXXOXXEXXXXXXXXEXXOXXXXXX
XXXXXXOXXEXXXXXXXXEXXOXXXXXX
XOOOOOOOOOOOOXXOOOOOOOOOOOOX
XOXXXXOXXXXXOXXOXXXXXOXXXXOX
XOXXXXOXXXXXOXXOXXXXXOXXXXOX
XPOOXXOOOOOOO@EOOOOOOOXXOOPX
XXXOXXOXXOXXXXXXXXOXXOXXOXXX
XXXOXXOXXOXXXXXXXXOXXOXXOXXX
XOOOOOOXXOOOOXXOOOOXXOOOOOOX
XOXXXXXXXXXXOXXOXXXXXXXXXXOX
XOXXXXXXXXXXOXXOXXXXXXXXXXOX
XOOOOOOOOOOOOOOOOOOOOOOOOOOX
XXXXXXXXXXXXXXXXXXXXXXXXXXXX
1100
840
660
